EA ./textures/dark_texture.xpm
WE ./textures/mid_dark_texture.xpm
NO ./textures/texture_north.xpm
SO ./textures/mold_texture.xpm

C 255,100,100
F 255,50,50

1111
11111
1111111111
1000N00001			110111
1000000001			111111
1000000001
1000000001
1000000001
1000000001
1000000001
1000000001
1111111111