NO NO.xpm
SO SO.xpm
WE EA.xpm
EA WE.xpm

C 155,100,160
F 111,111,111

 11111111
1000000001
1000000001
1000000001
10000N0001
1000000001
1000000001
1000000001
1000000001
 11111111