EA ./textures/dark_texture.xpm
WE ./textures/mid_dark_texture.xpm
NO ./textures/texture_north.xpm
SO ./textures/mold_texture.xpm

C 255,100,100
F 255,50,50
11111
 101
10001
 1N1
  1
11111