F 1,25,60
C 65,86,153
EA texture_east.xpm
WE texture_west.xpm
NO texture_north.xpm
SO texture_south.xpm
111111111111111111111111111111111111111111111111111111111111111111111111111111111111
100000000000000000000000000000000000000000000000000000000000000000000000000000000001
100000000000000000000000000000000000000000000000000000000000000000000000000000000001
100000000000000000000000000000000000000000000000000000000000000000000000000000000001
100000000000000000000000000000000000000000000000000000000000000000000000000000000001
100000000000000000000000000000000000000000000000000000000000000000000000000000000001
100000000000000000000000000000000000000000000000000000000000000000000000000000000001
100000000000000000000000000000000000000000000000000000000000000000000000000000000001
100000000000000000000000000000000000000000000000000000000000000000000000000000000001
10000000000000000000000W000000000000000000000000000000000000000000000000000000000001
100000000000000000000000000000000000000000000000000000000000000000000000000000000001
100000000000000000000000000000000000000000000000000000000000000000000000000000000001
100000000000000000000000000000000000000000000000000000000000000000000000000000000001
100000000000000000000000000000000000000000000000000000000000000000000000000001110001
100000000000000000000000000000000000000000000000000000000000000000000000000001 10001
100000000000000000000000000000000000000000000000000000000000000000000001111111110011
111000000000000000000000000000000000000000000000000000000000000000000011111111100001
100000000000000000000000000000000000000000000000000000000000000000000000000000000001
100000000000000000000000000000000000000000000000000000000000000000000000000001110001
100000000000000000000000000000000000000000000000000000000000000000000000000001 10001
111111111111111111111111111111111111111111111111111111111111111111111111111111 11111