F 53,53,53
C 1,1,1
EA texture_est.xpm
WE texture_west.xpm
NO texture_north.xpm
SO texture_south.xpm
11111111111
10000000001
10000S00001
10000000001
11111111111