


F 2,2,2
C 1,1,1
EA texture_est.xpm
WE texture_west.xpm
NO texture_north.xpm
SO texture_south.xpm
            111111111111111111
            100000000000000001
            100001111111111111
111111111111100001
1000000000000000E1
100000000001110001
100000000001 10001
111111111111 11111