F 107,69,60
C 65,86,153
EA texture_est.xpm
WE texture_west.xpm
NO texture_north.xpm
SO texture_south.xpm
            111111111111111111
            100000000000000001
            100001111111111111
111111111111100001
1000000000000000E1  1111
100000000001110001  1001
100000000001 10001  1111
111111111111 11111