F 1,187,1
C 70,238,255
EA texture_east.xpm
WE texture_west.xpm
NO texture_north.xpm
SO texture_south.xpm
111111111111111111
100000000000000001
100000000000000001
1000000E0000000001
100000000000000001  11111
100000000001110001  10001
100000000001 10001  11111
100001111111110011       1111
11111111111110000111111111001
100000000000000001  1111 1001
100000000001110001  1001 1001
100000000001 10001  1111 1111
111111111111 11111
