F 1,127,127
C 70,,238,0,,
EA ./textures/texture_east.xpm
WE ./textures/texture_west.xpm
NO ./textures/texture_north.xpm
SO ./textures/texture_south.xpm
111111111111111111
100000000000000001
100000000000000001
100000000000000001
100000000000000001  11111
100000000001110001  10001
100000000001 10001  11111
100001111111110011       
11111111111110000111111111111
100000000000000001  1111 1001
100000000001110001  1001 1001
100010000001 10001  1111 1111
1001 1000001110001
1N01 1000000000001
1111 1111111111111
