            111111111111111111
            100000000000000001
            100000111111111111
111111111111100001
100000000000000001
100000000001110001
100000000001 10001
111111111111 11111