F 2,2,2
C 1,1,1
EA texture_est.xpm
WE texture_west.xpm
NO texture_north.xpm
SO texture_south.xpm
11111111
10000001
1E000001
11111111