F 1,24,60
C 65,86,14
EA texture_east.xpm
WE texture_west.xpm
NO texture_north.xpm
SO texture_south.xpm
            111111111111111111
            100000000000000001
            100001111111111111
111111111111100001
100000000000000001  11111
101000000001110001  10001
1E1000000001 10001  11111
111111111111111111